*2*2*2*2*2*2*2*2*2*2*2*2*2*2*2*2*
201010301010101010101010301010102
*1*1*1*1*1*1*1*1*1*1*1*1*1*3*1*1*
201010101030101010101010103010102
*1*1*1*1*1*3*1*1*1*1*1*1*1*1*1*1*
201010101010101030103010101010102
*1*1*1*1*1*1*1*3*1*3*1*1*1*1*1*1*
201010101010101010101030101010102
*3*1*1*1*1*1*1*1*1*1*1*3*1*1*1*3*
201010103010101010101010101010102
*1*1*1*3*1*1*3*1*1*1*1*1*1*1*1*1*
2G1010101010301010101010101030102
*1*3*1*1*1*1*1*1*1*1*1*3*1*1*3*1*
201030101010101010101010301010102
*1*1*1*1*1*1*1*3*3*1*1*1*1*1*1*1*
201010101010103030301010101R10102
*1*1*1*1*1*1*1*3*3*1*1*1*1*1*1*1*
201010101010103030301010101010102
*1*1*1*1*1*1*1*3*3*1*1*1*1*1*1*1*
201010101010101010101010101010102
*1*1*1*1*1*1*1*1*1*1*1*1*1*1*1*3*
201010101030101010301010101010102
*1*3*1*1*1*3*1*1*3*1*1*1*1*3*1*1*
203010101010101010101010103010102
*1*1*1*1*1*1*3*1*1*1*1*1*1*1*1*1*
201010101010103010101010101010102
*1*1*1*1*1*1*1*1*1*3*1*1*1*1*1*1*
201010101010101010103010101010102
*3*1*1*1*1*1*1*1*1*1*1*1*1*1*3*1*
201010103010101010101010101010302
*1*1*1*3*1*1*1*1*1*1*1*1*1*1*1*1*
201010101010301010101010301010102
*2*2*2*2*2*2*2*2*2*2*2*2*2*2*2*2*
