3 15
1 9
0 11
13 5
6 1
Y
*2*2*2*2*2*2*2*2*2*2*2*2*2*2*2*2*
201010103010101010103010101010102
*1*1*1*1*1*1*1*1*1*1*1*1*3*1*1*1*
201010101010101010101010301010102
*1*1*1*1*1*3*1*1*1*1*1*1*1*1*1*3*
201010101010301010101010101010102
*1*1*1*1*1*1*1*1*1*1*1*1*1*1*1*1*
201010101010101010301010101010102
*1*1*3*1*1*1*1*1*1*3*1*1*1*1*1*1*
201010301010101010101010101010302
*3*1*1*1*1*1*1*1*1*1*3*1*1*1*3*1*
201010101010103010101030101010102
*1*3*1*1*1*1*1*3*1*1*1*1*1*1*1*1*
203010101010101010101010101010102
*1*1*1*1*1*1*1*3*3*1*1*1*1*1*1*1*
201010101010103030301010101010102
*1*1*1*1*1*1*1*3*3*1*1*1*1*1*1*1*
201010101010303030301010101010102
*1*1*1*1*1*3*1*3*3*1*1*1*3*1*1*1*
201010101010101010101010301010102
*1*1*3*1*1*1*1*2*2*1*1*1*1*1*1*3*
201030101010101010101030101010102
*1*1*1*1*1*1*1*1*1*1*3*1*1*1*1*1*
201010101010101010101010101010102
*3*1*1*1*1*1*1*1*1*1*1*1*1*1*3*1*
201010101010101010101010101010302
*1*1*1*1*3*1*1*1*1*1*1*1*1*1*1*1*
201010103010101010101010101010102
*1*1*1*1*1*1*1*1*1*1*1*1*1*1*1*1*
201010101010301010101030101010102
*1*1*1*1*1*1*3*1*1*1*1*3*1*1*1*1*
201010101030101010101010101030102
*2*2*2*2*2*2*2*2*2*2*2*2*2*2*2*2*
N
3
